            #
           # #
       ####   #####
       #   O      #
        #    X   #
         #      #
          # P  #
           #  #
            #
